9
1 3 1 h 2 
2 1 1 v 2
3 4 1 h 3
4 5 3 v 2
5 4 4 v 2
6 2 4 v 2
7 1 3 h 3
8 2 5 v 3
9 5 5 h 2
